wanted: bread, pizza, node.js, spaghetti, coffee, america

1 = number + red
2 = 1 + double
69 = golden + six
abandon = not + rescue
acid = pollution + water
acknowledged = acknowledge + received
acknowledging = acknowledge + ignoring
adjusted = adopted + schedule
adopt = abandon + not
adopted = adopt + cable
advertising = fish + sandwich board
advice = help + newspaper
agatha christie = double cheeseburger + murder on the orient express
aging = time + vanity
agree = everything + somebody + yes
airplane = plane + rocky mountains
airport = plane + farm
airship = steampunk plant + wind
alarm = hill + warning
alcohol = drink + fire
alice = mirror + well
alien = mud + space plant
allergy = pollen + swamp
allow = latin + ticket + low
alone = awake + privacy
america = continent + passion
anarchy = riot + terrorist
ancient = elder
android = glass + robot
angels = heaven + knifes
angry = crash + mad
anonymous = hacktivist + vomit
anorexia = dietician + politics
anorexic = anorexia + diet coke + lottery
ant = earth + skeeter
apocalypse = super volcano + tsunami
apple juice = apple + straw
apple pie = apple juice + mud
apple tree = apple pie + plant
apple = land + pie
archer = robin hood + water
arrow = archer + dust
art = mirror + museum
artist = art + tsunami
asphalt = earth + fuel + mud
aspirin = headache + water
assess = asset + essay
assessment = assess + emptier
asset = butt + property
astrocybernetics = astronomy + cybernetics
astronomy = telescope + wine
atlantis = stonehenge + tsunami
attempt = latin + fail + fight
attempted = attempt + done
aunt = ant + kite
avocado = kali + seed
awake = coffee + morning
balsamic vinegar of modena = vinegar + fog + vine + wine
banana = crash + fruit fly
bank = money + skunk
bankrupt = balloon + moonflower + pig
bankruptcy = crash + wealth
baptism = priest + water
baptismal wave = baptism + tsunami
bath = ocean + shower
battery = acid + fire + steam
battle = fire + war
bear = honey + mountain
bed = pillow
bee = pollen + smoke
berserker = fog + fire + norway
big bang = fire + universe
bird = egg
birthday = balloon + party
bitcoin = comet + money
black friday = thanksgiving + time
blade = obsidian + stone
blanket = wrap
blind = curtain + window
blunt = joint + expensive + weed
boat = ocean + wood
boba = juice + soap + tea
bollywood = indian + posters
bong = pipe + plant
bonus = crash + salary
bose-einstein condensate = innocent + physics
boss = fire + success + silk
bottle = earth + glass
bottom = low + top
boulder = stone
bp = loch ness monster + oil spill
bread = stone + warmth
bricktrap = brick + venus flytrap
bridge = troll + water
broken = drain + shattered
broom = dust + wood
brownies = pudding + weed
buddha bowl = buddha + guacamole
buddha hexasaurus = buddha bowl + jonah hexasaurus
buddha = nirvana + swamp
bug = swamp + windshield
bullet train = rocket + train
burger = fire + flying cow
butt = bottom + stop + time
cable = engine + seed + crash + television
cactus = plant + sand
cake = birthday + spongeplant
california = america + earthquake
camera = lens + tsunami
campfire = fire + dust + tree
can = tuna + wall
canada = bankrupt + maple
cannon = fire + pirate ship
cannonball = cannon + fire
capital = election + history + dust + peace
capitalism = capital + tennis
caps = agree + hats
carnival = flower + funnel cake
carnivore = tree + venus flytrap
carnivorous plant = plant + venus flytrap
cat = animal + static
cattle = ash + flock
cave = bear + stone
cd = fire + walkman
celebrity = bp + paparazzi
charcoal = campfire + earth
cheese wheel = cheese
cheese = milk + time
cheeseburger = cheese wheel + mosquito
cherry = flower + mountain + tree
chili = fire + stew
chimney = fire + mud + smoke
chocolate milk = milky way + mud
choo-choo = lizard + rainbow trout + train
cider = apple tree + fire
clean air = smog + vacuum
clean = broom + dust
climate change = methane + tsunami
clock = cigar + time
clone = animal + lens + swamp + glass + lake
closed = shop + steam + stonehenge
cloud trap = steam + typhoon + venus flytrap
coal = charcoal
coalition = coal + window
coconut milk = coconut + marsh
coconut tsunami = coconut milk + tsunami
coconut = palm tree + wind
coffee = android + pot
cognizant = help + recognize + regular
coin = metal + mud
coke = diamond + soda
collect = cap + gather
collected = collect + company + latin
college = hot + university
comedy = sock + tragedy
comet = smoke + star
comic = panel + tale
company = joint + stock
computer = technology
consequence = outcome + punish
consequences = consequence + flags
consist = persist + suspect
consistent = persist + reliable
constant = consistent + known
content = latin + satisfied
continent = earth + land
continuous = constant + time + when
cookies = brownies + fire
coral reef = coral + wind
coral = plant + sea
cotton = pigweed + plant
coughing = ash + dust + plant + stone
cpp = canada + sea + mountain + prayer
criminal = prisoner + time
crisis = crash + credit
critic = advice + destroy
crossing = asphalt + red sea
crown = priest + thorn
curiosity = mars + rover
cyber monday = black friday + surf
cybernetic tequila = astrocybernetics + tequila
cybernetics = cyber monday + health
cyclone = swamp + tornado
cyclops = swamp + titan
da vinci code = dust + scroll + tom hanks
dam = tree + water + wall
damn = dam + dust
damnation = damn + plant
dance = earth + cd + fire
dandelion = plant + wind
danger = dust + warning
date = farm + time + mirage
dating = date + water
david = slingshot + stone
day = earth + sunrise
debt = credit
decade = singer + ten
decline = latin + slide
deja vu = field + steam + time
demand = angry + want
denial = animal + question + climate change
desert = cactus + tsunami
desk = clock + table
desperate = desk + poorest
destroy = shatter + wreck
diamond = charcoal + dust
diet coke = coke + explosion
diet = healthy + trial
dietician = diet + latin
difficult = adjusted + hard
difficulty = difficult + us
dinosaur = carnivore + earth
disaster = avalanche + tsunami
discipline = advice + punishment
discover = found + reveal
division = denial + hotter + one + rose
divorce = sticky situation + tiger woods
done = debt + one
double cheeseburger = cheeseburger
double = mirror + single
down = crash + internet
dragon = airship + lava
dragonfly = dandelion + dragon
drain = black hole + water
dress = fabric + pink
drill = battery + diamond
drink = clean + water
druid = fire + stonehenge
drunk = engine + sake
duck and cover = dandelion + duck
duckling = dandelion patch + lake + water
dust mite = dust bowl + wind + microscope
dust trap = dust storm + venus flytrap
ear = not + selfie + sunflower
earthquake = tornado + tsunami + tsunami
ease = can + retiring + difficulty
eat = duck + seeds + food
economy = bread + coin
eden = flower + plant + lily
editor = critic + journalist
effort = decade + strive
egg = dinosaur
ego = hobbit + wind + narcissus
einstein = professor + time
elder = dragon + time
election = animal + voting
emerald = crash + diamond
empire state building = empire state + engine
empire state = america + new york
emptier = empty + wiser
empty = not + pocket
ended = endure + failed
ending = capitalism + never
ends = ended + saints
endure = enduring + import
enduring = ending + tougher
energy drink = mountain dew + red bull
energy = fire + power
engagement = diamond + ring
engineer = choo-choo + smoke + time
english = not + celebrity + latin
escape = prison + tsunami + wind
essay = editor + lesson
eternity = aeon + time
evidence = magnifying glass + vase
evolution = steam + tree of life
expensive = alarm + airship + fire + diamond
experience = loss + time
explore = discover + left
explosion = destruction + steam
export = explore + port
eye patch = glass + pirate
eye = cyclops + kite
face = eye
fail = loss + pass
failed = attempted + mask
fairy = dragonfly + dust
fallout = ash + duck and cover
fame = money + star
family = duck + duckling
farewell = parting + flower + steam
farm = earth + family
farmer = earth + engineer
fence = earth + wall
few = quantity + weak
fewer = ego + few
field = earth + farm
fight = battle + war
filter = drain + paper
finished = done + latin
fire dance = fire + hula
fire tornado = cyclone + fire
fire truck = fire + fire + water + fire tornado
fireplace = brick + fire truck
fireworks = dandelion + volcano
first lady = fisherman’s wife + president
fish = cloud trap + sea
fishbowl = fish + water
fisherman = water + worker
fisherman’s wife = fisherman + campfire + dust
fishing rod = engine + fishing
fishing = fish + lake
flags = sails + tongues
flamenco = continent + fire dance
flamingo = flamenco + water
flat earth = planet + steamroller
flock = bird
flower = fairy + plant
flying cow = carnivorous plant + tornado
flying fish = fish + wind
flying pig = flying cow + mud
flying starfish = starfish + wind
flypaper = dust trap + venus flytrap
flytrap = earth + flypaper
focus = lens + stew
food = farm + plant
forest = plant + tree
forever = lake + time + eternity
forget = memory + wind
found = map + wind + lost
france = earth + bath + continent
freedom = destroy + slave
french revolution = earth + wind + france
frog = fishing rod + swamp
frost = diamond + fog
fruit fly = fresh + time + wind
fuel = engine + food
fun = steam + water park
funnel cake = tornado + venus flytrap
funner = fun
funnier = ego + funner
fusion = drain + nuclear
galaxy = star
gap = bridge + not
garbage = time + waste
gasoline = fuel + water
gate = engine + fence
gather = learned + meet
gatorade = funnel cake + gator
genie = smoke + wizard
glacier = fjord
glass = ash + dust + stone
glider = airplane + airport + slow
glue = flypaper + fuel
gnome = earth + fairy
goblin = coal + gnome
golden = bankruptcy + silence
goldfish = fire + fishbowl
goodbye = cannonball + farewell
google sky = google + telescope
google translate = effort + translation
google = android + cloud
goose = duckling + stone
gosling = goose + water
gps = boat + satellite
graduation = cake + time + university + prisoner
grain = harvest + stone
grass = field
gravel = broken + stone
green dragon = emerald + volcano
green = crash + emerald
greenpeace = pollution + tarzan
greenwashing = climate change + marketing
guacamole = airplane + avocado
guarantee = garbage + never + laughter + pride
guillotine = earth + french revolution
guilt = animal + regret
hack = computer + fire
hacker = cloud + hack
hacktivist = hacker + tsunami
halloween = ghost + witch
hangover = crash + drink
happiness = buddha + whale
hard = cider + average + gap
hats = graduation + head + collected
hay = allergy + farm
head = crash + guillotine
headache = hangover + lava + sea
headline = aunt + paper + wine
health = aspirin + happiness
healthy = damn + health
heaven = cloud + eden
helipope = engine + flytrap + pope
hello = energy + goodbye
help = message + sos
hi = hello + human
high = bong + smoke
hill = grass + mountain
hippie = clean air + vegan
history = disaster + time
hit = hi + truck
hobbit = goblin + wind
hodl = bitcoin + sniper
holy spirit = baptismal wave + wind
homework = book + pencil
honey = bee + steam
honor = shame + value
horse = hay + plant
hot chocolate = chocolate milk + steam
hot springs = geysers + lake
hot = chili + fire
hotter = number + warmer
hourglass = time + tornado
house = brick + fireworks
hula = flypaper + hawaii
human = evolution + time
hurricane = breeze + wind
hurt = forget + help
hydrogen = fusion + water
ice age = aeon + glacier
ice cream = ice + volcano
ice cube = diamond + ice
ice = frost
iceland = fjord + volcano
idol = stone + prayer
ignoring = listening + not
illusion = mirage + smoke
immigrant = ship + sculpture + tsunami
immune = allergy + system
import = admit + export
income = silent + tax
indian = can + reservation
inflation = economy + fire
injured = hurt + sick
innocent = guilt + immune
insect = animal + bug
interest = bank + wine + time
internet = bullet train + satellite
irish coffee = fog + whiskey
irish rain = irish coffee + rain
iron = clean + steam
ironman = spiderman + steam
ironmouse = ironman + mousetrap
island = ocean + stone
islands = oceans + out
japan = lake + rice + ocean + tempest
jet = flying fish + steam
jetpack = jet
jewel = diamond + stone
joint = hippie + smoke
jonah hex = jonah + train station
jonah hexasaurus = jonah hex + pirateosaurus
jonah = fishing + whale
journalist = cattle + reporter
juice = engine + bee + wind + clean + time
jumping = dust + fire + skipping
jungle = forest
justice = judge + statue
kali = lotus + storm
karma = justice + time
kite = jewel + wind
knife = blade + obsidian
knifes = knives + retiring
knives = pets + sharp
known = anonymous + not
labor = eye + work
land = earth + fjord
landship = airship + earth
landslide = avalanche + earth
language = poetry + animal + mouth
larynx = coughing + stone
laser = fire + focus
last = desperate + latin + possible
laughter = comedy + fire
laundry = clean + time
lawn = dust + grass
learned = lesson + owned
left = one + wrong + spin
leprechaun = dust + irish rain
less = fewer + tea + unicorn
lesson = fail + time
leviathan = rain + sea serpent
life = big bang + swamp
lighthouse = chimney + ocean
lightning = engine + thunder
lily = flower + water
listening = animal + shatter + ear + salary
lizard = dragon + pollen + food + swamp
loan = bank + lake
local = not + tourist
loch ness monster = dragon + lake
loch ness = atlantis + swamp
loss = crossing + profit
lost = ghost + gps
lottery = money + mud
love = dating + fire
low = high + vacuum
lucky = leprechaun + tumbleweed
lung = cough + water
mad = mass + sad
mammoth = ice age + plant
mansion = house + swamp
manure = hay + stinky
map = maple + paper
maple leaf = maple + tornado
maple syrup = maple leaf + water
mario = eye patch + toadstool
market = animal + economy
marketing = advertising + rage
mars = dust storm + planet
marsh = garden + swamp
mask = boulder + mud + face
me = balsamic vinegar of modena + drunk
meade = honey + water
meal = food
meat = animal + harvest
meatball = fire + sos + stone
media = headline + prayer + wine
meet = meat + social
memory = deja vu + water
message = beach + bottle
metal = earth + iron
methane = hydrogen + swamp
michelle obama = first lady + space tacopazzi
milk = flying cow + water
milky way = galaxy + water
minecraft = planet + sandbox
mirage = desert + ocean
mist = fog + lawn
monkey wrench = engine + monkey
monkey = dust + jungle
monocle = glass + loch ness monster
monster = loch ness + volcano
monument = history + stone
moon = earth + star
moonflower = moon + venus flytrap
morning = glass + hangover
moses = smoke + tablet
mosquito = incense + swamp
mountain dew baja blast = mountain dew + tobacco
mountain dew = dandelion + mountain
mountain range = mountain
mouse trap = cheese + engine
mousetrap = mouse trap + rocket
mouth = earth + throat
mud bowl = disaster + sandstorm + mud
muddy pig = flying pig + mud
murder mystery = agatha christie + glider
murder on the orient express = damnation + orient express
murderer = murder mystery + incense + surfing
museum = history + house
nail = iron + wood
narcissus = lake + mirror
native = ancient + local
nebula = smoke + universe
new york = sea + statue of liberty
night = flower + moon
nirvana = lake + mountain + crocodile + flower
no = college + language + opposition
nobody = anonymous + empty
node.js = cpp + web
noise = crash + static
norway = fjord + mountain
notice = noticed + recommendation
noticed = safety + stuck + recognized
notices = notice + ends + rejects
nuclear = engine + fallout
number = count
nun = wind + window + priest
obsidian = emerald + earth + fire
oceans = acknowledging + seas
ogre = monster + troll
oil spill = funnel cake + lake
older = time + wiser
opposition = not + eat + surgeon
orange juice = orange + tax
orange = juice + nail
orc = goblin + dust + lake
orient express = rich + train
out = not + tent
outcome = income + not
oven = fireplace + stone
own = loan + not
owned = number + single + own
pain = headache + inflation
palm tree = palm + steam
palm = island + tree
pancake = maple syrup + stone
panel = clean + solar
paparazzi = camera + weed
papyrus = carnivore + swamp + earth + plant
parade = carnival + earth + water
paradox = freedom + slavery
paragraph = prison + time
parking = earth + traffic
parting = moses + ocean
pass = gate + mountain
passion = fire + interest
peace = crisis + piece
peach = fruit + lava
peat = charcoal + swamp
pegasus = horse + wind
pencil = charcoal + water
penguin = ice cube + tsunami + marsh
periscope = drill + mirror
permission = allow + message
persist = last + resist
pets = earth + zoo + socks
physics = crash + sum + university
pie = mud + peach
piece = lake + pie
pig = dust + morning + mud
piggyback rider = engine + ocean + pig
pigweed = dandelion + pig
pillow = mirror + cough + plant + stone
pilot = jet + jetpack
pink = flamingo + water
pipe = hobbit + plant
piranha = goldfish + swamp
pirate ship = ghost ship + smoke
pirate = boat + fog + plant
pirateosaurus = dinosaur + pirate ship
pitch = rain + tar
pizza = pie + stone
plane = pilot + swamp
planet = dust + earth
pluto = piggy bank + planet
pneumatic = engine + lung
pocket = steam + universe + earth + kite
poem = paragraph + passion
poetry = poem
poison = plant + swamp + teapot
politics = monkey + tuxedo + system
pollution = earth + oil spill
poorest = not + richest
pope = crown + priest
port = village + water
possible = internet + satisfaction + latin
posters = consist + notices
potato chip = kite + potato
potato = mirror + clay + pollen
potion = medicine + water
pottery = clay + mist
power = nuclear + steam
prayer = dust + incense
prediction = glass + witch + tsunami
pressure = diamond + time
previous = remote + yesterday
pride = dust mite + parade
priest = fog + prayer
prince = frog + smoke
prison = brick + island
prisoner = dust + prison
privacy = bonus + fence
professor = funnel cake + tree + monocle
profit = hurricane + money
profits = revenue + sighs
profound = profits + proud
project = risk + scope
property = apocalypse + destruction + explosion + own
proposal = mud + sea + engagement
protest = greenpeace + manure
proud = family + radio + success
psalm = david + flower + smoke
pudding = maple syrup + mud
pump = drain + engine
pumpkin pie = pig + pumpkin
pumpkin = halloween + time
punain = sentence + underworld + rain
punainen = punain + roast
punish = discipline + hit
punishment = karma + sentence
python = crash + snake
quality = cotton + flower + guarantee
quantity = closed + quality
quesadilla = cheese + taco
question = curiosity
quicksand = cloud trap + mud
radio = microscope + wave
raft = boat + plant
rage = berserker + mountain dew
railroad = train + tree
rain = cloud + microscope
rainbow trout = cloud + fish
ranger = garden + time
reality = illusion + television
received = message + dragon + someday
recognize = not + wreck
recognized = acknowledged + strange
recommend = advice + require
recommendation = project + proposal + recommend
red bull = engine + engine + mountain dew
red dragon = fire + green dragon
red sea = red dragon + water
red = bed + punainen
reef = coral + marsh
refrigerator = engine + ice
regret = beach + hangover
regular = not + sale
reject = decline + filter
rejects = caps + reject
reliable = trust + up
remote = battery + brick
reporter = farmer + newspaper
require = consequences + demand
rescue = helicopter + mountain
reservation = native + prison
resist = admit + stop
resistance = power + resist
retiring = aging + high
reveal = canceling + secret
revenue = car + traffic ticket
rice pudding = dust + rice
rice = harvest + tsunami
rich = genie + money
richer = money + rich
richest = richer
riddle of the sphinx = riddle + shepherd
riddle = mud + traffic + sphinx
ring = diamond + mud
riot = farm + protest
risk = danger
road trip = flat earth + road
road = engine + gravel
roast = duck + oven
robin hood = forest + meade
robot = dust + monkey wrench
rocket = engine + potion
rocky mountains = dust bowl + mountain range
rough = pain + sandpaper
rougher = rough + younger
rover = engine + mars
rust = iron + rain
sad = ash + dad
safety = danger + touchdown
sail = raft + wind
sailor anarchy = anarchy + sailor moon
sailor moon = flying starfish + sailor
sailor = sail + time
sails = david + sail
saints = angels + tests
salary = labor + sodium
sale = fire + market
salsa = fire + salad
salt = ocean + potato chip
saltwater = engine + salt
sand = dust + ocean
sandal = sandstorm + wood
sandbox = engine + sand
sandpaper = kite + stone + sand
sandstorm = dust + sand
sandwich board = sandwich + window
sandwich = roast + wind
satellite = earth + radio waves
satisfied = cat + finished
scalpel = knife + mountain
scent = perfume + water
schedule = boss + transportation + time
science = hourglass + microscope
scope = arrow + periscope
scotch = fog + peat
scroll = gnome + papyrus
sculpture = piece
sea serpent = dragon egg + ocean
sea star = ocean + star
sea urchin = lava + sea star
sea = lake + lake + water
seas = ease + see
secret = night + whisper
see no evil = mirror + monkey
see = blind + not
seed = fire + glass + wave + plant
seeds = dandelion patch + wind
selfie = mirror + narcissus
serious = comic + not
seven = lucky + one
sex = date + drunk
shadow = orc + smoke
shallow = never + profound
shame = fame + pain
shark = fish + see no evil
sharknado 2 = norway + ocean + shark
sharknado 2: the second one = empire state building + quesadilla + sharknado
sharknado 3 = cybernetic tequila + sharknado 2
sharknado 3: oh hell no! = salt + sharknado 2: the second one
sharknado 4 = protest + sharknado 3
sharknado 4: the 4th awakens = greenwashing + sharknado 4
sharp = blunt
shatter = glass + tornado
shattered = glass + crash + hangover
sheep = flock + psalm
shepherd = druid + flock
shinkansen = ogre + train
ship = ocean + sail
shipwreck = crash + lighthouse
shop = market + mirror
shower = gosling + tsunami + water
sick = cough + lung + water
sigh = love + lung
sighs = murderer + sigh
signal = galaxy + radio
silence = noise + paradox
silent = smell + wind + prayer
silk = insect + sheep
sing = dance + mouth
singer = injured + sing
single = divorce + ring
six = less + seven
skeeter = mosquito + sea urchin
skid = fog + tire
skimming = stone + surfing
skipping = skimming + stone
skunk = scent + swamp
slam = homework + wall
slate = clean + stone
slave = dust + prisoner
slavery = crash + slave
slide = plant + skid
slingshot = pilot + stone
slow = quicksand + steam
smell = cloud + skunk
smelly volcano = smoke + stinky volcano
smog = fog + gasoline
snake = poison + stone
sniper = arrow + newspaper
soap = clean + seed
social = jumping + media
sock = clean + sandal
socks = grain + sock
soda = saltwater + volcano
sodium = mirror + salt
sog = fog + sos
soggy = sog + water
solar = fire + sun
somebody = nobody + time
someday = serious + tomorrow
sos = ocean + radio
soup = pumpkin + water
souped-up = engine + soup
spa = hot springs + plant
space alice = alice + rocket + ship
space plant = nebula + plant
space ship = engine + galaxy
space station = space ship
space tacopazzi = leviathan + space station + tacopazzi
space time pilot = beach + fire + typhoon + space alice + time pilot
spaghetti = da vinci code + meatball
sphinx = aeon + brick + stone
spider-man = perfume + dust trap + flypaper
spiderman = lava + spider-man
spin = spa + wind
sponge = ocean + soggy
spongebob = sponge + steam
spongeplant = spongebob + venus flytrap
star = planet
starfish = sea star + wave
static = ash + radio
statue = laundry + monument
steampunk pirate ship = steam + steampunk pirate
steampunk plant = plant + ocean + steampunk
steampunk tree = smoke + steampunk plant
steampunk = planet + steam
steamroller = souped-up + steam
steel = fog + metal
stew = soup + steam
sticky situation = flypaper + landslide
stink = skunk + smoke
stinky volcano = stink + volcano
stinky = ice cream + skunk
stock = immigrant + sock
stonehenge = steampunk pirate ship + stone
storm = planet + wind
story = campfire + time
strange = physics + stranger
stranger = not + ranger
straw = hay
streamer = stream + twitch
streaming = permission + continuous + shallow
stress = pressure
strive = fire + slow + thrive
stuck = crash + flypaper
success = stress + time
sum = one + outcome
sun = plant + star
sunflower = sun + wind
sunrise = land + sunset
sunset = lake + sun
super bowl = dust bowl + mud bowl
super volcano = mountain range + yellowstone
superstar = plant + refrigerator + star
surf thor = surfing + thor
surf = reef + wave
surfer = rice pudding + steam + wave
surfing thor = surf thor + surfing
surfing = piggyback rider + tsunami
surgeon = scalpel + smoke
survive = escape + tsunami
survivor = shipwreck + surf
suspect = alone + evidence
sweat = gatorade + steam
sweatshop = pollution + slavery
swimming pool = mansion + water
sword = steel + stone
system = planet + solar
tablet = slate + stone
taco = earth + salsa
tacopazzi = paparazzi + taco
tale = story + wind
tank = engine + mammoth
tarzan = jungle + prince
tax = money + tea party
tea party = fireworks + tea
teapot = earth + tea
technology = science
telescope = engine + lens
television = dust + fog + radio
tempest = storm + tea
ten = one + tablet
tennis = lawn + slam
tent = alien + pitch
tequila = alcohol + sweatshop
terrorist = destruction + tea
tests = assessment + islands
thanksgiving = history + meal
the answer to life, the universe, and everything = coconut tsunami + riddle of the sphinx
them = dust + then
then = crash + when
thomas = choo-choo + mario
thor = lightning + surfer
thorn = plant + sword
thrive = content + survive
throat = cough + tea
thunder = smoke + storm
ticket = parking + time
tiger woods = tiger + tree
tiger = jungle + tsunami
time laser = laser + pirate ship + time
time pilot = pilot + time laser
tire = earth + pneumatic
titan = landship + volcano
toadstool = fog + plant + storm
tobacco = earth + pipe
tom hanks = island + survivor
tomorrow = thomas + time
tongues = hangover + holy spirit + wind
top = brick + spin
tornado = tempest + wind
touchdown = mud + mud bowl + super bowl
tougher = previous + rougher
tour = road trip + superstar
tourist = shadow + tour
tourists = fog + yellowstone + iceland
toxic = crash + poison
traffic ticket = car + paper
traffic = crash + slavery
tragedy = crash + tourists
train station = train
train = snake + steam
transistor = engine + radio
translation = language
transportation = railroad + train
tree of life = steampunk tree + swamp
tree = plant
trial = acid + beach + thanksgiving + vampire + criminal + fire + wind
triffid = muddy pig + plant
troll = fog + orc
truck = engine + monster
trust = coalition + credit
tumbleweed = triffid + wind
tuna = crash + lava + rice
tuxedo = marsh + penguin
twitch = streaming + unique
typhoon = tea + tempest
underworld = pluto + volcano
unicorn = boulder + pegasus + smoke
unique = clone + not
universe = planet + time
university = professor
up = down + not
us = resistance + them
vacuum = dustbuster + lawn
value = money + time
vampire = piranha + smoke
vanity = mirror + tea + wood
vase = marsh + pottery
vegan = life + salad
venus flytrap = plant + swamp
vine = glue + plant
vinegar = plant + smelly volcano + water
virtual reality = cave + reality
voice = larynx + wind
vomit = pottery + sick
voting = landslide + system
vr artist = artist + virtual reality
vr idol = idol + vr artist
vtuber = streamer + vr idol
walkman = radio + transistor
wall = stop + tsunami
want = not + waste
war = jet + tank
warmer = blanket + richer
warmth = fire + fireplace
warning = signal + tsunami
waste = swamp + toxic
water park = ocean + swimming pool
wave = water + wind
weak = not + week
wealth = dandelion + forever + green
web = marsh + spider
weed = dandelion + plant
week = day + time
well = earth + pump
whale = duck + dust + ocean
when = question + time
whiskey = lava + scotch
whisper = voice + water
whole = clean + pie
window = glass + rain
windshield = engine + glass
wiser = experience + funnier
witch hut = witch
wizard = time + witch hut
work = farm + sweat
worker = fire + slave
wrap = dust + human + paper
wreck = crash + whole
wrinkle = clean + iron
wrong = me + prediction
yellowstone = mountain range + volcano
yes = division + no
yesterday = rust + wrinkle + tomorrow
younger = never + older
zoo = garden + park
ghost = campfire + earth + wind
magic = plant + steam + unicorn
normal = not + superstar + gap
sake = water + rice
something = always + latin + nun + somebody
witch = mud + water + teapot